{
  "id": 1,
  "title": "Level 1: Lab Entrance",
  "grid": [
    "#########################",
    "#...........#...........#",
    "#..#####....#....#####..#",
    "#...........#...........#",
    "#....###.........###....#",
    "#.......................#",
    "#..#.....########.....#.#",
    "#..#........#.........#.#",
    "#..#####....#....#####..#",
    "#...........#...........#",
    "#....###.........###....#",
    "#.......................#",
    "#..#####....#....#####..#",
    "#...........#...........#",
    "#...........#...........#",
    "#.......................#",
    "#.......................#",
    "#########################"
  ],
  "player_spawn": [2, 15],
  "zombie_spawns": [[22, 2], [21, 10], [4, 3], [17, 14]],
  "key_position": [11, 9],
  "exit_position": [22, 15]
}
