{
  "id": 3,
  "title": "Endless Mode",
  "grid": [
    "#########################",
    "#.......................#",
    "#..###.............###..#",
    "#.......................#",
    "#.......#######.........#",
    "#.......#.....#.........#",
    "#.......#.....#.........#",
    "#.......................#",
    "#..###.............###..#",
    "#.......................#",
    "#.........#####.........#",
    "#.......................#",
    "#..###.............###..#",
    "#.......................#",
    "#.......#.......#.......#",
    "#.......................#",
    "#.......................#",
    "#########################"
  ],
  "player_spawn": [12, 9],
  "zombie_spawns": [[2, 2], [22, 2], [2, 15], [22, 15], [12, 2]],
  "key_position": null,
  "exit_position": [12, 15]
}
